RUS = "countries/Russia.txt"
UMR = "countries/Ukraine.txt"             #Temporary Military Administration of West Ukraine
SUO = "countries/Suomi.txt"               #Finland
TSE = "countries/Estland.txt"
RIG = "countries/Latvien.txt"
LTU = "countries/Livonien.txt"
EWS = "countries/Sweden.txt"
NED = "countries/Denmarken.txt"
DEA = "countries/Norwegien.txt"
LSI = "countries/Islandien.txt"
LRI = "countries/Irlandien.txt"
WEI = "countries/Weimar.txt"
PLS = "countries/Polska.txt"
CZC = "countries/Czechoslovakia.txt"
VUN = "countries/Hungary.txt"
LUK = "countries/Luxemburg.txt"
GNE = "countries/Great_Britain.txt"
ARF = "countries/France.txt" 
BAV = "countries/Bavaria.txt" 
AVS = "countries/Austria.txt" 
RUM = "countries/Romania.txt" 
BEM = "countries/Belgium.txt" 
NET = "countries/Netherlands.txt" 
FRE = "countries/France.txt" 
SWZ = "countries/Switzerland.txt" 
ITL = "countries/Italy.txt" 
BOH = "countries/Bulgaria.txt" 
GRC = "countries/Greece.txt" 
SRB = "countries/Serbia.txt" 
HOR = "countries/Croatia.txt" 
ALG = "countries/Albania.txt" 
ISP = "countries/Spain.txt" 
PRO = "countries/Portugal.txt" 
KRU = "countries/Kurdistan.txt" 
OSM = "countries/Ottoman.txt" 
GRU = "countries/Georgia.txt" 
AZE = "countries/Azerbaijan.txt" 
ANI = "countries/Armenia.txt" 
AME = "countries/USA.txt" 
JAN = "countries/Japan.txt" 
TUV = "countries/Tuva.txt" 
BLS = "countries/Belarus.txt" 
CHM = "countries/Communist_China.txt" 
MAK = "countries/Mongolia.txt" 
EGK = "countries/Egypt.txt" 
PLE = "countries/Palestine.txt" 
CHX = "countries/Xibei_San_Ma.txt" 
CHS = "countries/China.txt"
SAR = "countries/Saarland.txt"
IAQ = "countries/Iraq.txt"
SAT = "countries/South_Africa.txt"
LIR = "countries/Liberia.txt"
ASS = "countries/Aussa.txt"
ETI = "countries/Ethiopia.txt"
IND = "countries/India.txt"
AFN = "countries/Afganistan.txt"
IRA = "countries/Iran.txt"
BRZ = "countries/Brazil.txt"
MEC = "countries/Mexico.txt"
VAT = "countries/Vatican_city.txt"
MON = "countries/Monaco.txt"
MMN = "countries/Manchukou.txt"
MNN = "countries/Mengkukuo.txt"
TIT = "countries/Tibet.txt"
BUB = "countries/Bhutan.txt"
NEL = "countries/Nepal.txt"
THA = "countries/Thailand.txt"               #Siam
AVT = "countries/Australia.txt"
NEZ = "countries/New_Zealand.txt"
PHL = "countries/Philippines.txt"
INN = "countries/Indonesia.txt"
FEO = "countries/Oman.txt"
FEE = "countries/Yemen.txt"                  #North_Yemen
SAA = "countries/Saudi_Arabia.txt" 
URU = "countries/Urugay.txt" 
SUP = "countries/Paraguay.txt"          